ACTIVITY	ACTIVITY
ADHD	COPD,AFB,ADHD
ADVENTURE	RISK,ADVENTURE
AFB	NEBwomen,NEBmen,HIGHMATH,EA,COPD,AFB,ADHD
AGREE	COGEMP,AGREE
ALLERGYCAT	HAYFEVERb,HAYFEVER,ASTHMA,ASTECZRHI,ALLERGYPOLLEN,ALLERGYDUST,ALLERGYCAT
ALLERGYDUST	HAYFEVERb,HAYFEVER,ASTHMA,ASTECZRHI,ALLERGYPOLLEN,ALLERGYDUST,ALLERGYCAT
ALLERGYPOLLEN	HAYFEVERb,HAYFEVER,ASTHMA,ASTECZRHI,ALLERGYPOLLEN,ALLERGYDUST,ALLERGYCAT
ALZ	ALZ
ASTECZRHI	HAYFEVERb,HAYFEVER,ECZEMA,ASTHMA,ASTECZRHI,ALLERGYPOLLEN,ALLERGYDUST,ALLERGYCAT
ASTHMA	HAYFEVERb,HAYFEVER,ASTHMA,ASTECZRHI,ALLERGYPOLLEN,ALLERGYDUST,ALLERGYCAT
AUDIT	DPW,AUDIT
BMI	BMI
CANNABIS	CANNABIS
COGEMP	COGEMP,AGREE
CONSC	CONSC
COPD	SELFHEALTH,COPD,AFB,ADHD
CP	SELFMATH,HIGHMATH,EA,CP
CPD	CPD
DELAYDISC	HIGHMATH,EA,DELAYDISC
DEP	SWB,NEURO,LONELY,DEP
DPW	DPW,AUDIT
EA	RELIGATT,HIGHMATH,EA,DELAYDISC,CP,AFB
ECZEMA	HAYFEVERb,ECZEMA,ASTECZRHI
EVERSMOKE	EVERSMOKE
EXTRA	LEFTOUT,EXTRA
FAMSAT	WORKSAT,SWB,FRIENDSAT,FAMSAT
FINSAT	SWB,SELFHEALTH,LONELY,FINSAT
FRIENDSAT	WORKSAT,SWB,LEFTOUT,FRIENDSAT,FAMSAT
HAYFEVER	HAYFEVERb,HAYFEVER,ASTHMA,ASTECZRHI,ALLERGYPOLLEN,ALLERGYDUST,ALLERGYCAT
HAYFEVERb	HAYFEVERb,HAYFEVER,ECZEMA,ASTHMA,ASTECZRHI,ALLERGYPOLLEN,ALLERGYDUST,ALLERGYCAT
HEIGHT	HEIGHT
HIGHMATH	SELFMATH,HIGHMATH,EA,DELAYDISC,CP,AFB
LEFTOUT	SWB,LONELY,LEFTOUT,FRIENDSAT,EXTRA
LONELY	SWB,NEURO,LONELY,LEFTOUT,FINSAT,DEP
MENARCHE	VOICEDEEP,MENARCHE
MIGRAINE	MIGRAINE
MORNING	MORNING
NARCIS	NARCIS
NEARSIGHTED	NEARSIGHTED
NEBmen	NEBwomen,NEBmen,AFB
NEBwomen	NEBwomen,NEBmen,AFB
NEURO	SWB,NEURO,LONELY,DEP
OPEN	OPEN
READING	READING
RECHARGE	RECHARGE
RELIGATT	RELIGATT,EA
RELIGBLF	RELIGBLF
RISK	RISK,ADVENTURE
SELFHEALTH	SELFHEALTH,FINSAT,COPD
SELFMATH	SELFMATH,HIGHMATH,CP
SWB	WORKSAT,SWB,NEURO,LONELY,LEFTOUT,FRIENDSAT,FINSAT,FAMSAT,DEP
VOICEDEEP	VOICEDEEP,MENARCHE
WORKSAT	WORKSAT,SWB,FRIENDSAT,FAMSAT
