ADHD1	/disk/genetics/PGS/Aysu/PGS_Repo_pipeline/derived_data/6_MTAG_multi/ADHD1/ADHD1_trait_1_formatted.txt
ADVENTURE1	/disk/genetics/PGS/Aysu/PGS_Repo_pipeline/derived_data/6_MTAG_multi/ADVENTURE1/ADVENTURE1_trait_1_formatted.txt
AFB1	/disk/genetics/PGS/Aysu/PGS_Repo_pipeline/derived_data/6_MTAG_multi/AFB1/AFB1_trait_1_formatted.txt
AGREE1	/disk/genetics/PGS/Aysu/PGS_Repo_pipeline/derived_data/6_MTAG_multi/AGREE1/AGREE1_trait_1_formatted.txt
ALLERGYCAT1	/disk/genetics/PGS/Aysu/PGS_Repo_pipeline/derived_data/6_MTAG_multi/ALLERGYCAT1/ALLERGYCAT1_trait_1_formatted.txt
ALLERGYDUST1	/disk/genetics/PGS/Aysu/PGS_Repo_pipeline/derived_data/6_MTAG_multi/ALLERGYDUST1/ALLERGYDUST1_trait_1_formatted.txt
ALLERGYPOLLEN1	/disk/genetics/PGS/Aysu/PGS_Repo_pipeline/derived_data/6_MTAG_multi/ALLERGYPOLLEN1/ALLERGYPOLLEN1_trait_1_formatted.txt
ASTECZRHI1	/disk/genetics/PGS/Aysu/PGS_Repo_pipeline/derived_data/6_MTAG_multi/ASTECZRHI1/ASTECZRHI1_trait_1_formatted.txt
ASTHMA1	/disk/genetics/PGS/Aysu/PGS_Repo_pipeline/derived_data/6_MTAG_multi/ASTHMA1/ASTHMA1_trait_1_formatted.txt
AUDIT1	/disk/genetics/PGS/Aysu/PGS_Repo_pipeline/derived_data/6_MTAG_multi/AUDIT1/AUDIT1_trait_1_formatted.txt
COGEMP1	/disk/genetics/PGS/Aysu/PGS_Repo_pipeline/derived_data/6_MTAG_multi/COGEMP1/COGEMP1_trait_1_formatted.txt
COPD1	/disk/genetics/PGS/Aysu/PGS_Repo_pipeline/derived_data/6_MTAG_multi/COPD1/COPD1_trait_1_formatted.txt
CP1	/disk/genetics/PGS/Aysu/PGS_Repo_pipeline/derived_data/6_MTAG_multi/CP1/CP1_trait_1_formatted.txt
DELAYDISC1	/disk/genetics/PGS/Aysu/PGS_Repo_pipeline/derived_data/6_MTAG_multi/DELAYDISC1/DELAYDISC1_trait_1_formatted.txt
DEP1	/disk/genetics/PGS/Aysu/PGS_Repo_pipeline/derived_data/6_MTAG_multi/DEP1/DEP1_trait_1_formatted.txt
DPW1	/disk/genetics/PGS/Aysu/PGS_Repo_pipeline/derived_data/6_MTAG_multi/DPW1/DPW1_trait_1_formatted.txt
EA1	/disk/genetics/PGS/Aysu/PGS_Repo_pipeline/derived_data/6_MTAG_multi/EA1/EA1_trait_1_formatted.txt
ECZEMA1	/disk/genetics/PGS/Aysu/PGS_Repo_pipeline/derived_data/6_MTAG_multi/ECZEMA1/ECZEMA1_trait_1_formatted.txt
EXTRA1	/disk/genetics/PGS/Aysu/PGS_Repo_pipeline/derived_data/6_MTAG_multi/EXTRA1/EXTRA1_trait_1_formatted.txt
FAMSAT1	/disk/genetics/PGS/Aysu/PGS_Repo_pipeline/derived_data/6_MTAG_multi/FAMSAT1/FAMSAT1_trait_1_formatted.txt
FINSAT1	/disk/genetics/PGS/Aysu/PGS_Repo_pipeline/derived_data/6_MTAG_multi/FINSAT1/FINSAT1_trait_1_formatted.txt
FRIENDSAT1	/disk/genetics/PGS/Aysu/PGS_Repo_pipeline/derived_data/6_MTAG_multi/FRIENDSAT1/FRIENDSAT1_trait_1_formatted.txt
HAYFEVER1	/disk/genetics/PGS/Aysu/PGS_Repo_pipeline/derived_data/6_MTAG_multi/HAYFEVER1/HAYFEVER1_trait_1_formatted.txt
HIGHMATH1	/disk/genetics/PGS/Aysu/PGS_Repo_pipeline/derived_data/6_MTAG_multi/HIGHMATH1/HIGHMATH1_trait_1_formatted.txt
LEFTOUT1	/disk/genetics/PGS/Aysu/PGS_Repo_pipeline/derived_data/6_MTAG_multi/LEFTOUT1/LEFTOUT1_trait_1_formatted.txt
LONELY1	/disk/genetics/PGS/Aysu/PGS_Repo_pipeline/derived_data/6_MTAG_multi/LONELY1/LONELY1_trait_1_formatted.txt
MENARCHE1	/disk/genetics/PGS/Aysu/PGS_Repo_pipeline/derived_data/6_MTAG_multi/MENARCHE1/MENARCHE1_trait_1_formatted.txt
NEBmen1	/disk/genetics/PGS/Aysu/PGS_Repo_pipeline/derived_data/6_MTAG_multi/NEBmen1/NEBmen1_trait_1_formatted.txt
NEBwomen1	/disk/genetics/PGS/Aysu/PGS_Repo_pipeline/derived_data/6_MTAG_multi/NEBwomen1/NEBwomen1_trait_1_formatted.txt
NEURO1	/disk/genetics/PGS/Aysu/PGS_Repo_pipeline/derived_data/6_MTAG_multi/NEURO1/NEURO1_trait_1_formatted.txt
RELIGATT1	/disk/genetics/PGS/Aysu/PGS_Repo_pipeline/derived_data/6_MTAG_multi/RELIGATT1/RELIGATT1_trait_1_formatted.txt
RISK1	/disk/genetics/PGS/Aysu/PGS_Repo_pipeline/derived_data/6_MTAG_multi/RISK1/RISK1_trait_1_formatted.txt
SELFHEALTH1	/disk/genetics/PGS/Aysu/PGS_Repo_pipeline/derived_data/6_MTAG_multi/SELFHEALTH1/SELFHEALTH1_trait_1_formatted.txt
SELFMATH1	/disk/genetics/PGS/Aysu/PGS_Repo_pipeline/derived_data/6_MTAG_multi/SELFMATH1/SELFMATH1_trait_1_formatted.txt
SWB1	/disk/genetics/PGS/Aysu/PGS_Repo_pipeline/derived_data/6_MTAG_multi/SWB1/SWB1_trait_1_formatted.txt
VOICEDEEP1	/disk/genetics/PGS/Aysu/PGS_Repo_pipeline/derived_data/6_MTAG_multi/VOICEDEEP1/VOICEDEEP1_trait_1_formatted.txt
WORKSAT1	/disk/genetics/PGS/Aysu/PGS_Repo_pipeline/derived_data/6_MTAG_multi/WORKSAT1/WORKSAT1_trait_1_formatted.txt
ADHD5	/disk/genetics/PGS/Aysu/PGS_Repo_pipeline/derived_data/6_MTAG_multi/ADHD5/ADHD5_trait_1_formatted.txt
ADVENTURE4	/disk/genetics/PGS/Aysu/PGS_Repo_pipeline/derived_data/6_MTAG_multi/ADVENTURE4/ADVENTURE4_trait_1_formatted.txt
AFB2	/disk/genetics/PGS/Aysu/PGS_Repo_pipeline/derived_data/6_MTAG_multi/AFB2/AFB2_trait_1_formatted.txt
AFB6	/disk/genetics/PGS/Aysu/PGS_Repo_pipeline/derived_data/6_MTAG_multi/AFB6/AFB6_trait_1_formatted.txt
ALLERGYCAT5	/disk/genetics/PGS/Aysu/PGS_Repo_pipeline/derived_data/6_MTAG_multi/ALLERGYCAT5/ALLERGYCAT5_trait_1_formatted.txt
ALLERGYDUST5	/disk/genetics/PGS/Aysu/PGS_Repo_pipeline/derived_data/6_MTAG_multi/ALLERGYDUST5/ALLERGYDUST5_trait_1_formatted.txt
ALLERGYPOLLEN5	/disk/genetics/PGS/Aysu/PGS_Repo_pipeline/derived_data/6_MTAG_multi/ALLERGYPOLLEN5/ALLERGYPOLLEN5_trait_1_formatted.txt
ASTECZRHI5	/disk/genetics/PGS/Aysu/PGS_Repo_pipeline/derived_data/6_MTAG_multi/ASTECZRHI5/ASTECZRHI5_trait_1_formatted.txt
ASTHMA5	/disk/genetics/PGS/Aysu/PGS_Repo_pipeline/derived_data/6_MTAG_multi/ASTHMA5/ASTHMA5_trait_1_formatted.txt
AUDIT2	/disk/genetics/PGS/Aysu/PGS_Repo_pipeline/derived_data/6_MTAG_multi/AUDIT2/AUDIT2_trait_1_formatted.txt
AUDIT5	/disk/genetics/PGS/Aysu/PGS_Repo_pipeline/derived_data/6_MTAG_multi/AUDIT5/AUDIT5_trait_1_formatted.txt
COPD5	/disk/genetics/PGS/Aysu/PGS_Repo_pipeline/derived_data/6_MTAG_multi/COPD5/COPD5_trait_1_formatted.txt
CP5	/disk/genetics/PGS/Aysu/PGS_Repo_pipeline/derived_data/6_MTAG_multi/CP5/CP5_trait_1_formatted.txt
DELAYDISC4	/disk/genetics/PGS/Aysu/PGS_Repo_pipeline/derived_data/6_MTAG_multi/DELAYDISC4/DELAYDISC4_trait_1_formatted.txt
DEP6	/disk/genetics/PGS/Aysu/PGS_Repo_pipeline/derived_data/6_MTAG_multi/DEP6/DEP6_trait_1_formatted.txt
DPW2	/disk/genetics/PGS/Aysu/PGS_Repo_pipeline/derived_data/6_MTAG_multi/DPW2/DPW2_trait_1_formatted.txt
DPW5	/disk/genetics/PGS/Aysu/PGS_Repo_pipeline/derived_data/6_MTAG_multi/DPW5/DPW5_trait_1_formatted.txt
EA6	/disk/genetics/PGS/Aysu/PGS_Repo_pipeline/derived_data/6_MTAG_multi/EA6/EA6_trait_1_formatted.txt
FAMSAT4	/disk/genetics/PGS/Aysu/PGS_Repo_pipeline/derived_data/6_MTAG_multi/FAMSAT4/FAMSAT4_trait_1_formatted.txt
FINSAT4	/disk/genetics/PGS/Aysu/PGS_Repo_pipeline/derived_data/6_MTAG_multi/FINSAT4/FINSAT4_trait_1_formatted.txt
FRIENDSAT4	/disk/genetics/PGS/Aysu/PGS_Repo_pipeline/derived_data/6_MTAG_multi/FRIENDSAT4/FRIENDSAT4_trait_1_formatted.txt
HAYFEVER5	/disk/genetics/PGS/Aysu/PGS_Repo_pipeline/derived_data/6_MTAG_multi/HAYFEVER5/HAYFEVER5_trait_1_formatted.txt
HIGHMATH6	/disk/genetics/PGS/Aysu/PGS_Repo_pipeline/derived_data/6_MTAG_multi/HIGHMATH6/HIGHMATH6_trait_1_formatted.txt
LEFTOUT5	/disk/genetics/PGS/Aysu/PGS_Repo_pipeline/derived_data/6_MTAG_multi/LEFTOUT5/LEFTOUT5_trait_1_formatted.txt
LONELY6	/disk/genetics/PGS/Aysu/PGS_Repo_pipeline/derived_data/6_MTAG_multi/LONELY6/LONELY6_trait_1_formatted.txt
MENARCHE5	/disk/genetics/PGS/Aysu/PGS_Repo_pipeline/derived_data/6_MTAG_multi/MENARCHE5/MENARCHE5_trait_1_formatted.txt
NEBmen2	/disk/genetics/PGS/Aysu/PGS_Repo_pipeline/derived_data/6_MTAG_multi/NEBmen2/NEBmen2_trait_1_formatted.txt
NEBmen6	/disk/genetics/PGS/Aysu/PGS_Repo_pipeline/derived_data/6_MTAG_multi/NEBmen6/NEBmen6_trait_1_formatted.txt
NEBwomen2	/disk/genetics/PGS/Aysu/PGS_Repo_pipeline/derived_data/6_MTAG_multi/NEBwomen2/NEBwomen2_trait_1_formatted.txt
NEBwomen6	/disk/genetics/PGS/Aysu/PGS_Repo_pipeline/derived_data/6_MTAG_multi/NEBwomen6/NEBwomen6_trait_1_formatted.txt
NEURO6	/disk/genetics/PGS/Aysu/PGS_Repo_pipeline/derived_data/6_MTAG_multi/NEURO6/NEURO6_trait_1_formatted.txt
RELIGATT4	/disk/genetics/PGS/Aysu/PGS_Repo_pipeline/derived_data/6_MTAG_multi/RELIGATT4/RELIGATT4_trait_1_formatted.txt
RISK4	/disk/genetics/PGS/Aysu/PGS_Repo_pipeline/derived_data/6_MTAG_multi/RISK4/RISK4_trait_1_formatted.txt
SELFHEALTH5	/disk/genetics/PGS/Aysu/PGS_Repo_pipeline/derived_data/6_MTAG_multi/SELFHEALTH5/SELFHEALTH5_trait_1_formatted.txt
SELFMATH5	/disk/genetics/PGS/Aysu/PGS_Repo_pipeline/derived_data/6_MTAG_multi/SELFMATH5/SELFMATH5_trait_1_formatted.txt
SWB6	/disk/genetics/PGS/Aysu/PGS_Repo_pipeline/derived_data/6_MTAG_multi/SWB6/SWB6_trait_1_formatted.txt
VOICEDEEP5	/disk/genetics/PGS/Aysu/PGS_Repo_pipeline/derived_data/6_MTAG_multi/VOICEDEEP5/VOICEDEEP5_trait_1_formatted.txt
WORKSAT4	/disk/genetics/PGS/Aysu/PGS_Repo_pipeline/derived_data/6_MTAG_multi/WORKSAT4/WORKSAT4_trait_1_formatted.txt
